
NO ./game_images/catel-B.xpm
EA ./game_images/catel-BD.xpm
WE ./game_images/catel-OD.xpm
SO ./game_images/catel-O.xpm

C 189,240,255
F  146,141,132



11111111111111111111111111
100000000011100000000000001
10110000011 110000000000001
100100000001000000000000111111111
111111111011000001110000000000001
100000000011000001110111110111111
11110111111111011100000010001
11110111111111N11101010010001
11000000110101011100000010001
10000000000000001100000010001
10000000000000001101010010001
1100000111010101111101111000111
11110111 10110101 11111010001
11111111 1111111 111111111111
